2333333333333423333333333334
1............11............1
1.2334.23334.11.23334.2334.1
1O1__1.1___1.11.1___1.1__1O1
1.6335.63335.65.63335.6335.1
1..........................1
1.2334.24.23333334.24.2334.1
1.6335.11.63342335.11.6335.1
1......11....11....11......1
633334.16334_11_23351.233335
_____1.12335_65_63341.1_____
_____1.11__________11.1_____
_____1.11_23333334_11.1_____
333335.65_1______1_65.633333
______.___1______1___.______
333334.24_1______1_24.233333
_____1.11_63333335_11.1_____
_____1.11__________11.1_____
_____1.11_23333334_11.1_____
233335.65_63342335_65.633334
1............11............1
1.2334.23334.11.23334.2334.1
1.6341.63335.65.63335.1235.1
1O..11.......__.......11..O1
634.11.24.23333334.24.11.235
235.65.11.63342335.11.65.634
1......11....11....11......1
1.2333356334.11.2335633334.1
1.6333333335.65.6333333335.1
1..........................1
6333333333333333333333333335